r........
xxxx.xxx.
.........
.xxx.xxx.
..x......
........g
