r.......g
...xx....
x...x..x.
x..xx..x.
.........
